################################
#000000000000000000000000000000#
#000000000000000000000000000000#
#000000000000000000000000000000#
#000000000000000000000000000000#
#000000000000000000000000000000#
#000000000000000000000000000000#
#0000000000000000000000000000002
#0000000000000000000000000000002
#000000000000000000000000000000#
#000000000000000000000000000000#
#000000000000000000000000000000#
#000000000000000000000000000000#
#000000000000000000000000000000#
#000000000000000000000000000000#
################################