################################
#000000000000000000000000000000#
#000000000000000000000000000000#
#000000000000000000000000000000#
#000000000000000000000000000000#
#000000000000000000000000000000#
################0#####0#########
30000000000#000000000#000000000#
30000000000#000000000#000000000#
####0#######0###################
#000000000000000000000000000000#
#000000000000000000000000000000#
#000000000000000000000000000000#
#000000000000000000000000000000#
#000000000000000000000000000000#
################################