################################
#000000000000000000000000000000#
#000000000000000000000000000000#
#000000000000000000000000000000#
#000000000000000000000000000000#
#000000000000000000000000000000#
#000000000000000000000000000000#
10000000000000000000000000000001
10000000000000000000000000000001
#000000000000000000000000000000#
#000000000000000000000000000000#
#000000000000000000000000000000#
#000000000000000000000000000000#
#000000000000000000000000000000#
#000000000000000000000000000000#
################################